# HYRULE

FFFFFFFFFFFFFFFMMMMMMMMMMMMMMMMMMMMMMMMMMM
FGGFGFGFGGGGGGGMMMMMMMDDDDDMMMMMMDDDDMMMMM
FGGFGGGFGFGGGGGGMMMMMDDDDDDDMMMMDDDDDDMMMM
FGFFGFGFGFGGFGGGGMDDDDDDDDDDDDDDDDDDDDDDMM
FGGGGFGFGFGGFGGGGMDMMDDDDDDDMMMMDDDDDDMMMM
FGFFGFGFGFGFFFGGGMDMMMDDDDDMMMMRMDDDDMRMMM
FGFFGFGGGFGGGGGGGMDMMMMMMMMMMMMRMMMMMMRMMM
FGFFFFGFFFGGGGGGGMDMMMMMMMMMMMMRMMMMMMRMGM
FGGFGGGGGFGGRGGGGMDDDDDDDDDDDMMRMMMMMMRMGM
FFFFGFFFGGGRRRGGGMDMMMMMDMMMDMMRMMMMMMRMGM
FGGFGGGGGGRRRRRGGMMMFFFMMMFFFFFRGGMMGGRGGM
FGGFGGFGGGGRRRGGGGGGGGGGGGGGGGRRRRRRRRRGGM
FGGFGGFGGGGGRGGGGGGGGGGGGGGGGGRGGFGGGGGFGM
FGGFGGFGGGGGGGGGGFFFGGGFFFFGGGRGGGGGGFGFGM
FGGGGGGGGGGGGGGGGGGGGGGGGGGGGGRGFGFGFFGFGM
FGFFFFFGFFFGGGGGGGGGGGGGGGGGGGRGGGGGGGGGGM
FGGGGGGGGGGGGGGGGRRRRRRRRRRGGGGGMMMMMMMMMM
FGGGGGGGGRGGFGFGGRGGGGGGGGRGGGRGMDDDDDDDDM
FGFGGFGGGRGGGGGGGRGFGGGGFGRRRRRGMDMDDMDDDM
FGFGGFGGGRGGFGFGGGGGGGGGGGRGGGGGMDMMMMMMMM
FGFGGFGGGRGGGGGGGRGGGGGGGGRGGGMGMDDDDDDDDM
FGFGGFGGGRGFFFFGGRGFGGGGFGGGGGMGMDMMMMDMMM
FGGGGGGGGRGGGGGGGRGGGGGGGGRGMGMGMDDDDDDDDM
FGGGGGGGGGGFFFFGGRRRRGGRRRRGMGMGMMMDDMMMMM
FFFFFFFGGFFFFFFFFFGGGGGGGGRGMGMGGGGGGGGGGM
FFFFFFGGFFFFFGFFFFFGFFFGGGRGMGGGGGGGGGGGGM
FGFGFGGGFFFFGGGFFFFGFFFGGGRGMGGGMMMMMMMMMM
MGGGFGGGFFFGGGGGFFFGGGGGGGRGGGGGGGGMGGGGGM
MGGGFGGGFFFFGGGFFFFGFGGGGGRGGGGGGGGMGGGGGM
MGGGGGGGGFFFFGFFFFGGFGGGGGRRRGRRRRGMGMMMMM
MGGGGGGGGGGGGGGGGGGGGGGGGGGGGGGGGRGGGGGGGM
MMMMMMMMMGGGGMMMMMMMGGMMMMGGGGGGGRMMMMMMGM
MDDDDDDDMGGGGMGGGGGGGGGGGMGGGGGGGRMMMMMMMM
MDMMDDDDMGGGGMGGGGGGGGFGGMGGRRRRRRRRMMRRMM
MDMMDDDDMGGGGMGFGGRRGGFGGMGGRRMRRRRRMMRRMM
MDDDDDDDMGGMGMGGGGRRGGFGGMGGRRRRMMRRMMRRMM
MDDDDDDDMGGMGGGGGGGGGGGGGMGGRRRRMMRRMMRRMM
MDDDDDDMMMMMGGFGGGGGFFFGGMGGRRRRRRRRMMRRMM
MDDDDDDDDMMMGGFGRRRGGFGGGMGGRRRRRRRRMMRRMM
MDDDDDDDDMMMGGFGGGGGGFGGGMGGRRRRRRRRRRRRMM
MDDDDDDDDDGGGGGGGGGGGGGGGMMMRRRRRRRRRRRRMM
MMMMMMMMMMMMMMMMMMMMMMMMMMMMMMMMMMMMMMMMMM
